
 SO               textures/south.xpm



EA        textures/east.xpm
C               141,229,249


NO         textures/north.xpm
F    151,155,166
WE textures/west.xpm

11111111111111111111111111111111111111111111111111111111111
100000000000000000000000000000000000000000000000000000000S1
10000000000000000000000000000000000000000000000000000000001
10000000000000000000000000000000000000000000000000000000001
10000000000000000000000000000000000000000000000000000000001
10000000000000000000000000000000000000000000000000000000001
10000000000000000000000000000000000000000000000000000000001
10000000000000000000000000000000000000000000000000000000001
10000000000000000000000000000000000000000000000000000000001
10000000000000000000000000000000000000000000000000000000001
10000000000000000000000000000000000000000000000000000000001
10000000000000000000000000000000000000000000000000000000001
10000000000000000000000000000000000000000000000000000000001
10000000000000000000000000000000000000000000000000000000001
10000000000000000000000000000000000000000000000000000000001
10000000000000000000000000000000000000000000000000000000001
11111111111111111111111111111111111111111111111111111111111