
NO textures/north.xpm
SO            textures/south.xpm
EA textures/east.xpm
WE      textures/west.xpm

C 141,229,249
F 151,155,166

11111
100W1
10001
11111
