NO textures/north.xpm
SO textures/south.xpm
WE textures/west.xpm
EA textures/east.xpm
F 110,153,15
C 155,155,155

        1111111111111111111111111
        1000000000000000000000001
        1100000000000000000000001
        1000000000000000000000001
111111111000000000000000000000001
1000000000000000E0000000000001111
100000000000000000000000000011111
1000000000000000000000000000 1
1000000000000000000000000000 1
1000000000000000000000000000 1
1000000000000000000101000000 1
1100000111010101111101111010 1
11110111 1110111 10111101000 1
11111111 1111111 1111111111111
