NO textures/north.xpm
SO textures/south.xpm
WE textures/west.xpm
EA textures/east.xpm

F 151,155,166
C 141,119,149

1111111111111
100000s000001
1000000000001
1000011100001
10001   10001
1000011100001
1000000000001
1000000000001
1111111111111