NO textures/north.xpm
SO textures/south.xpm
EA textures/east.xpm
WE textures/west.xpm

F 151,155,155
C 141,119,149

1111111111111
100S000000001
1000000000001
1000000000001
1000000000001
1000000000001 
1000000000001
1000000000001
1111111111111
