NO textures/north.xpm
SO textures/south.xpm
WE textures/west.xpm
EA textures/east.xpm

C 141, 119, 149
F 151,  155,  , 8,

111111111111
100000N000001
1000000000001
1000011100001
10001   10001
1000011100001
1111111111111
11111111111
100000000001
1000000000001
1111111111111






